00000000000000000000
00000000000000000000
00000111111111100000
00000111111111100000
00003222222222230000
00000111111111100000
00000000000000000000
00000000000000000000
00000000000000000000
00000000000000000000
