00000000000000000000
00000000000000000000
00000000000000000000
00000000111100000000
00000000122100000000
00000000111100000000
00022000000000022000
00000000000000000000
03333333000333333330
00000000000000000000