00000000000000000000
00000000000000000000
00100010001000100000
00000000000000000000
00000100010001000100
00000000000000000000
00100010001000100000
00000000000000000000
00000100010001000100
00000000000000000000